Tank
13
50
00000000000000000000000000000000000000000000000000
01111111111111111111111111111111111111111111111150
00000000000000000000000000020000000000000000000000
01111111111111111111111111111111111111111111111110
01111111111111111111111111111111111111111111111110
01111111111111111111111111111111111111111111111110
00000000000000000000000000010000000000000000000000
00000000000000000000000000010000000000000000000000
00000000000000000111111111131111111111111000000000
00000000000000000111111111111111111111111000000000
00000000000000000111111111111111111111111000000000
00000000000000000111111111111111111111114000000000
00000000000000000000000000000000000000000000000000